 @    ##     # 
   #### #  #   
 # ##    #$# ##
 #      ## $#  
  $##      # # 
 ### # # #     
##     ## #  ##
##  #$   ## ###
 # #  # $   #  
 #  #  ##     #
    # # #   #  
# #      ##### 
 #  # #     #  
##      #     #
  #   # ## #   
