@x    ##     #    ##
## #  #  $ # ##    #
 # ## #      ##  #  
   ##      # #  ### 
# # #     ##     ## 
#  ####  #    ## ###
 # #  #     #   #  #
  ##   $ #    # # # 
  #  # #    $ ##### 
 #  # #     #  ##   
   #     #  #   # ##
 #   ####       ##  
      #  # # ##     
 ### # #   #      # 
 ####       ##   #  
 # #       # # #    
 $#   #      ##     
  # #    #  #  $#   
#     ### #  # #    
  #      ## #     # 
